"a" = (/turf/space,/area)
"b" = (/turf/unsimulated/wall/auto/gannets,/area)
"c" = (/turf/unsimulated/grass,/area)
"d" = (/obj/machinery/light{icon_state = "tube1"; dir = 1},/turf/unsimulated/grass,/area)
"e" = (/obj/machinery/light{icon_state = "tube1"; dir = 8},/turf/unsimulated/grass,/area)
"f" = (/obj/machinery/light{icon_state = "tube1"; dir = 4},/turf/unsimulated/grass,/area)
"g" = (/turf/unsimulated/grass,/turf/unsimulated/floor/ledge,/area)
"h" = (/turf/unsimulated/grass,/turf/unsimulated/floor/ledge{icon_state = "ledge"; dir = 6},/area)
"i" = (/turf/unsimulated/floor/sand,/area)
"j" = (/turf/unsimulated/grass,/turf/unsimulated/floor/ledge{icon_state = "ledge"; dir = 10},/area)
"k" = (/turf/unsimulated/grass,/turf/unsimulated/floor/ledge{icon_state = "ledge"; dir = 4},/area)
"l" = (/turf/unsimulated/floor/stairs/dark,/area)
"m" = (/obj/machinery/light,/turf/unsimulated/floor/sand,/area)
"n" = (/turf/unsimulated/grass,/obj/machinery/light{icon_state = "tube1"; dir = 4},/turf/unsimulated/floor/ledge,/area)
"o" = (/obj/machinery/light{icon_state = "tube1"; dir = 8},/turf/unsimulated/floor/sand,/area)
"p" = (/turf/unsimulated/grass,/turf/unsimulated/floor/ledge{icon_state = "ledge"; dir = 8},/area)
"q" = (/obj/machinery/light{icon_state = "tube1"; dir = 4},/turf/unsimulated/floor/sand,/area)
"r" = (/obj/machinery/light{icon_state = "tube1"; dir = 1},/turf/unsimulated/floor/sand,/area)
"s" = (/turf/unsimulated/grass,/turf/unsimulated/floor/ledge{icon_state = "ledge"; dir = 5},/area)
"t" = (/obj/landmark/start,/turf/unsimulated/floor/sand,/area)
"u" = (/obj/landmark/start/latejoin,/turf/unsimulated/floor/sand,/area)

(1,1,1) = {"
aaaaaaaaaaaaaaaaaaaaaaaaaaaaaaaaaaaaaaaaaaaaaaaaaa
aaaaaaaaaaaaaaaaaaaaaaaaaaaaaaaaaaaaaaaaaaaaaaaaaa
aaaaaaaaaaaaaaaaaaaaaaaaaaaaaaaaaaaaaaaaaaaaaaaaaa
aaaaaaaaaaaaaaaaaaaaaaaaaaaaaaaaaaaaaaaaaaaaaaaaaa
aaaaaaaaaaaaaaaaaaaaaaaaaaaaaaaaaaaaaaaaaaaaaaaaaa
aaaaaaaaaaaaaaaaaaaaaaaaaaaaaaaaaaaaaaaaaaaaaaaaaa
aaaaaaaaaaaaaaaaaaaaaaaaaaaaaaaaaaaaaaaaaaaaaaaaaa
aaaaaaaaaaaaaaaaaaaaaaaaaaaaaaaaaaaaaaaaaaaaaaaaaa
aaaaaaaaaaaaaaaaaaaaaaaaaaaaaaaaaaaaaaaaaaaaaaaaaa
aaaaaaaaaaaaaaaaaaaaaaaaaaaaaaaaaaaaaaaaaaaaaaaaaa
aaaaaaaaaaaaaaaaaaaaaaaaaaaaaaaaaaaaaaaaaaaaaaaaaa
aaaaaaaaaaaaaaaaaaaaaaaaaaaaaaaaaaaaaaaaaaaaaaaaaa
aaaaaaaaaaaaaaaaaaaaaaaaaaaaaaaaaaaaaaaaaaaaaaaaaa
aaaaaaaaaaaaaaaaaaaaaaaaaaaaaaaaaaaaaaaaaaaaaaaaaa
aaaaaaaaaaaaaaaaaaaaaaaaaaaaaaaaaaaaaaaaaaaaaaaaaa
aaaaaaaaaaaaaabbbbbbbbbbbbbbbbbbbbbbbbaaaaaaaaaaaa
aaaaaaaaaaaaaabcccdcccdccccdccccdccccbaaaaaaaaaaaa
aaaaaaaaaaaaaabeccccccccccccccccccccfbaaaaaaaaaaaa
aaaaaaaaaaaaaabcccccccccccccggcccccccbaaaaaaaaaaaa
aaaaaaaaaaaaaabccccccccccgchiijggccccbaaaaaaaaaaaa
aaaaaaaaaaaaaabccccccccckiliiiiiijcccbaaaaaaaaaaaa
aaaaaaaaaaaaaabgggccccgghiiiiimiiijgnbaaaaaaaaaaaa
aaaaaaaaaaaaaaboiipcchiiiiiiiibboiiiibaaaaaaaaaaaa
aaaaaaaaaaaaaabiiipckiiiitiuiqbbiiiiibaaaaaaaaaaaa
aaaaaaaaaaaaaabiiijckiiimiiiiiiriiiiibaaaaaaaaaaaa
aaaaaaaaaaaaaabiiiipcsiibboiiiiiiiiiqbaaaaaaaaaaaa
aaaaaaaaaaaaaabiiiipckiqbbiiiiiiiiiiibaaaaaaaaaaaa
aaaaaaaaaaaaaaboiiijchiiiriiiiiiiiiiibaaaaaaaaaaaa
aaaaaaaaaaaaaabiiiiiliiiiiiiiiiiiiiiqbaaaaaaaaaaaa
aaaaaaaaaaaaaabiiiiiiiiiiiiiiiiiiiiiibaaaaaaaaaaaa
aaaaaaaaaaaaaabiiiiiiiiiiiiiiiiiiiiiibaaaaaaaaaaaa
aaaaaaaaaaaaaaboiiiiiiiiiiiiiiiiiiiiibaaaaaaaaaaaa
aaaaaaaaaaaaaabiiiiiiiiiiiiiiiiiiiiiqbaaaaaaaaaaaa
aaaaaaaaaaaaaabiiimiiiimiiimiiimiiiiibaaaaaaaaaaaa
aaaaaaaaaaaaaabbbbbbbbbbbbbbbbbbbbbbbbaaaaaaaaaaaa
aaaaaaaaaaaaaaaaaaaaaaaaaaaaaaaaaaaaaaaaaaaaaaaaaa
aaaaaaaaaaaaaaaaaaaaaaaaaaaaaaaaaaaaaaaaaaaaaaaaaa
aaaaaaaaaaaaaaaaaaaaaaaaaaaaaaaaaaaaaaaaaaaaaaaaaa
aaaaaaaaaaaaaaaaaaaaaaaaaaaaaaaaaaaaaaaaaaaaaaaaaa
aaaaaaaaaaaaaaaaaaaaaaaaaaaaaaaaaaaaaaaaaaaaaaaaaa
aaaaaaaaaaaaaaaaaaaaaaaaaaaaaaaaaaaaaaaaaaaaaaaaaa
aaaaaaaaaaaaaaaaaaaaaaaaaaaaaaaaaaaaaaaaaaaaaaaaaa
aaaaaaaaaaaaaaaaaaaaaaaaaaaaaaaaaaaaaaaaaaaaaaaaaa
aaaaaaaaaaaaaaaaaaaaaaaaaaaaaaaaaaaaaaaaaaaaaaaaaa
aaaaaaaaaaaaaaaaaaaaaaaaaaaaaaaaaaaaaaaaaaaaaaaaaa
aaaaaaaaaaaaaaaaaaaaaaaaaaaaaaaaaaaaaaaaaaaaaaaaaa
aaaaaaaaaaaaaaaaaaaaaaaaaaaaaaaaaaaaaaaaaaaaaaaaaa
aaaaaaaaaaaaaaaaaaaaaaaaaaaaaaaaaaaaaaaaaaaaaaaaaa
aaaaaaaaaaaaaaaaaaaaaaaaaaaaaaaaaaaaaaaaaaaaaaaaaa
aaaaaaaaaaaaaaaaaaaaaaaaaaaaaaaaaaaaaaaaaaaaaaaaaa
"}
